* Comments can be placed on these asterisk separator lines
Level 1
01000001100110000010
10000000000000000001
10000001000010000001
01000000111100000010
00000000000000000000
00011100011000111000
* The level name should be no more than 49 characters long
Level 2
10101010101010101010
01010101010101010101
00000000000000000000
00000000000000000000
00000000000000000000
00000000000000000000
* Bricks are 1s, space is 0
Last Level
11111111111111111111
01010101010101010101
00100010001000100010
00000000000000000000
00001000100010001000
00000000000000000000
%